                                                                                                                        
 000000000000000000000000000000000000000000000000000000000000000000000000000000000000000000                             
        0            0            0                       0                                                             
        0            0            0                       0                                                             
        0            0            0                       0                                                             
        0            0            0                       0                              0                0             
        0            0            0                       0                              0                0             
        0            0            0                       0                              0                0             
        0       0000000000000000000000000000000000000000000000000000000000000000000000000000000000000000000             
        0            0            0           0           0          0                   0                0             
        0            0            0           0           0          0                   0                0             
        0            0            0           0           0          0                   0                0             
        0            0                        0           0          0                   0                0             
        0            0                        0           0          0                   0                0     0       
        0            0                        0           0          0                   0                0     0       
        0            0                        0           0          0                   0                0     0       
        0            0                        0           0          0                   0                0     0       
        0            0 000000000000000000000000000000000000000000000000000000000000000000000000000000000000000000       
        0            0                        0           0          0                                          0       
        0            0                        0           0          0                                          0       
        0            0              0         0           0          0                                          0       
        0            0              0         0           0          0                 0                        0       
        0            0              0         0                      0                 0                        0       
        0            0              0         0                      0                 0                        0       
        000000000000000000000000000000000000000000000000000000000000000000000000000000000000000000              0       
        0            0              0         0                      0                 0                        0       
        0            0              0         0                      0                 0                        0       
        0            0              0         0                      0                 0                        0       
        0            0              0                                0                 0                        0       
        0            0              0                                0                 0                        0       
        0            0              0                                0                 0                        0       
        0            0   000000000000000000000000000000000000000000000000000000000000000000000000000000000000000000     
        00000000000000              0                                0                 0                                
                     0              0                                0                 0                                
                     0              0                                0                 0                                
                     0              0                                0                 0                                
                     0              0                                0                 0                                
    000000000000000000000000000000000000000000000000000000000000000000000000000000000000000000                          
                                                                     0                                                  
                                                                     0                                                  